1
0 0 0 0 0 0 0 0 0 5 5 0 0 0 0 0 0 0 0 0
0 0 0 0 0 0 0 0 5 0 0 5 0 0 0 0 0 0 0 0
0 0 0 0 0 0 0 0 5 0 0 5 0 0 0 0 0 0 0 0
0 6 0 6 0 6 0 5 0 2 2 0 5 0 6 0 6 0 6 0
4 0 4 0 4 0 4 0 2 0 0 2 0 4 0 4 0 4 0 4
0 6 0 6 0 6 0 2 0 2 2 0 2 0 6 0 6 0 6 0
0 0 0 0 0 0 0 0 2 0 0 2 0 0 0 0 0 0 0 0
0 0 0 0 0 0 0 2 0 0 0 0 2 0 0 0 0 0 0 0
0 0 0 0 0 0 2 0 3 0 0 3 0 2 0 0 0 0 0 0
0 0 0 0 0 6 0 3 0 7 7 0 3 0 6 0 0 0 0 0
0 0 0 0 0 6 0 3 0 7 7 0 3 0 6 0 0 0 0 0
0 0 0 0 0 0 6 0 3 0 0 3 0 6 0 0 0 0 0 0
0 0 0 0 0 0 0 6 0 0 0 0 6 0 0 0 0 0 0 0
0 0 0 0 0 0 0 0 6 0 0 6 0 0 0 0 0 0 0 0
0 0 0 0 0 0 0 0 0 6 6 0 0 0 0 0 0 0 0 0
0 0 1 0 0 0 0 0 0 0 0 0 0 0 0 0 0 1 0 0
0 1 7 1 0 0 0 0 0 0 0 0 0 0 0 0 1 7 1 0
0 0 1 0 0 0 0 0 0 0 0 0 0 0 0 0 0 1 0 0
0 0 0 0 0 0 0 0 0 0 0 0 0 0 0 0 0 0 0 0
0 0 0 0 0 0 0 0 0 0 0 0 0 0 0 0 0 0 0 0
2
0 0 0 0 0 1 0 5 5 5 5 5 5 0 1 0 0 0 0 0
0 0 0 0 1 0 5 5 0 0 0 0 5 5 0 1 0 0 0 0
0 0 0 1 0 5 5 0 0 0 0 0 0 5 5 0 1 0 0 0
0 0 1 0 5 5 0 0 0 0 0 0 0 0 5 5 0 1 0 0
0 1 0 5 5 0 0 0 0 0 0 0 0 0 0 5 5 0 1 0
0 0 5 5 0 0 0 0 0 0 0 0 0 0 0 0 5 5 0 0
5 5 5 0 0 0 0 4 0 4 0 4 0 4 0 0 0 5 5 5
0 0 0 0 0 0 0 0 4 0 0 0 4 0 0 0 0 0 0 0
0 0 0 0 0 0 0 4 0 4 0 4 0 4 0 0 0 0 0 0
0 0 0 0 0 0 0 0 0 0 4 0 0 0 0 0 0 0 0 0
0 0 0 0 0 0 0 0 0 4 0 4 0 0 0 0 0 0 0 0
0 0 0 0 0 0 0 2 2 2 0 2 2 2 0 0 0 0 0 0
0 7 0 6 0 0 2 2 0 0 2 0 0 2 2 0 0 6 0 7
7 0 7 0 6 0 2 0 0 0 0 0 0 0 2 0 6 0 7 0
0 7 0 7 0 6 0 0 0 0 0 0 0 0 0 6 0 7 0 7
0 0 7 0 7 0 6 0 6 0 6 0 6 0 6 0 7 0 7 0
0 0 0 7 0 7 0 6 0 6 0 6 0 6 0 7 0 7 0 0
0 0 0 0 7 0 7 0 6 0 6 0 6 0 7 0 7 0 0 0
0 0 0 0 0 0 0 0 0 0 0 0 0 0 0 0 0 0 0 0
0 0 0 0 0 0 0 0 0 0 0 0 0 0 0 0 0 0 0 0
3
0 0 2 2 2 2 2 2 2 2 2 2 2 2 2 2 2 2 0 0
5 0 0 2 0 0 2 0 0 5 5 0 0 2 0 0 2 0 0 5
0 5 0 0 2 2 0 0 5 0 0 5 0 0 2 2 0 0 5 0
0 0 5 0 0 0 0 5 0 1 1 0 5 0 0 0 0 5 0 0
7 0 0 5 0 0 5 0 1 0 0 1 0 5 0 0 5 0 0 7
7 7 0 0 5 5 0 1 0 6 6 0 1 0 5 5 0 0 7 7
7 7 7 0 0 5 0 1 0 6 6 0 1 0 5 0 0 7 7 7
0 0 7 0 0 0 5 0 1 0 0 1 5 5 0 0 0 7 0 0
0 0 7 7 0 0 0 5 0 1 1 0 5 0 0 0 7 7 0 0
0 0 7 0 2 0 0 0 5 0 0 5 0 0 0 2 0 7 0 0
7 7 7 0 2 2 0 0 0 5 5 0 0 0 2 2 0 7 7 7
7 7 0 0 0 2 2 0 0 0 0 0 0 2 2 0 0 0 7 7
7 0 0 0 0 2 2 2 0 0 0 0 2 2 2 0 0 0 0 7
0 0 0 0 6 0 0 2 2 0 0 2 2 0 0 6 0 0 0 0
0 0 0 6 6 0 0 0 0 3 3 0 0 0 0 6 6 0 0 0
0 0 6 6 0 0 0 0 0 3 3 0 0 0 0 0 6 6 0 0
0 6 6 0 0 0 0 0 0 0 0 0 0 0 0 0 0 6 6 0
6 6 0 0 0 0 0 0 0 0 0 0 0 0 0 0 0 0 6 6
0 0 0 0 0 0 0 0 0 0 0 0 0 0 0 0 0 0 0 0
0 0 0 0 0 0 0 0 0 0 0 0 0 0 0 0 0 0 0 0
4
0 0 0 0 6 0 6 0 6 0 6 0 6 0 6 0 6 0 0 0
0 0 0 6 0 6 0 6 0 6 0 6 0 6 0 6 0 6 0 0
0 0 0 0 6 0 6 2 6 0 6 2 6 0 6 0 6 0 0 0
7 0 0 0 0 2 2 2 2 0 0 2 2 2 2 0 0 0 0 7
7 7 0 0 0 2 2 2 0 4 4 0 2 2 2 0 0 0 7 7
0 7 7 0 0 2 2 0 4 4 4 4 0 2 2 0 0 7 7 0
0 0 3 3 3 3 0 5 4 4 4 4 1 0 3 3 3 3 0 0
0 0 0 2 2 0 5 5 0 0 0 0 1 1 0 2 2 0 0 0
0 0 0 0 2 0 5 5 6 0 0 6 1 1 0 2 0 0 0 0
0 0 0 0 2 2 0 5 6 6 6 6 1 0 2 2 0 0 0 0
0 0 0 7 0 2 2 0 6 6 6 6 0 2 2 0 7 0 0 0
0 0 7 0 7 0 0 2 0 6 6 0 2 0 0 7 0 7 0 0
0 7 0 7 0 1 1 0 2 0 0 2 0 5 5 0 7 0 7 0
7 0 7 0 1 1 1 1 0 2 2 0 5 5 5 5 0 7 0 7
0 7 0 1 1 0 0 1 1 0 0 5 5 0 0 5 5 0 7 0
7 0 1 1 0 0 0 0 1 6 6 5 0 0 0 0 5 5 0 7
0 0 0 1 1 0 0 1 1 0 0 5 5 0 0 5 5 0 0 0
0 0 0 0 1 1 1 1 0 0 0 0 5 5 5 5 0 0 0 0
0 0 0 0 0 1 1 0 0 0 0 0 0 5 5 0 0 0 0 0
0 0 0 0 0 0 0 0 0 0 0 0 0 0 0 0 0 0 0 0
5
0 0 0 6 0 7 0 7 7 7 7 7 7 0 7 0 6 0 0 0
0 0 7 0 6 0 7 0 7 0 0 7 0 7 0 6 0 7 0 0
2 0 0 7 0 6 0 7 0 0 0 0 7 0 6 0 7 0 0 2
2 2 0 0 7 0 6 0 0 5 5 0 0 6 0 7 0 0 2 2
0 2 2 0 0 7 0 6 0 0 0 0 6 0 7 0 0 2 2 0
0 0 2 2 0 0 7 0 6 0 0 6 0 7 0 0 2 2 0 0
7 0 0 2 2 0 0 1 1 1 1 1 1 0 0 2 2 0 0 7
0 7 0 0 2 2 0 0 0 1 1 0 0 0 2 2 0 0 7 0
0 0 7 0 0 2 2 0 0 0 0 0 0 2 2 0 0 7 0 0
6 0 0 7 0 0 2 2 0 0 0 0 2 2 0 0 7 0 0 6
6 6 0 0 7 0 0 0 0 0 0 0 0 0 0 7 0 0 6 6
6 6 0 0 7 0 0 0 0 0 0 0 0 0 0 7 0 0 6 6
6 0 0 7 0 0 4 4 0 5 5 0 4 4 0 0 7 0 0 6
0 0 7 0 0 4 4 0 5 5 5 5 0 4 4 0 0 7 0 0
0 7 0 0 4 4 0 5 5 0 0 5 5 0 4 4 0 0 7 0
7 0 0 4 4 0 5 5 0 6 6 0 5 5 0 4 4 0 0 7
0 0 4 4 0 5 5 0 7 6 6 7 0 5 5 0 4 4 0 0
0 4 4 0 5 5 0 7 6 0 0 6 7 0 5 5 0 4 4 0
4 4 0 5 5 0 7 6 7 0 0 7 6 7 0 5 5 0 4 4
4 0 5 5 0 7 6 7 0 2 2 0 7 6 7 0 5 5 0 4
6
3 3 3 0 7 7 7 7 0 0 0 0 7 7 7 7 0 3 3 3
3 3 3 3 0 6 6 6 6 0 0 6 6 6 6 0 3 3 3 3
0 0 0 1 1 0 7 7 7 7 7 7 7 7 0 1 1 0 0 0
0 0 0 1 1 1 0 7 7 0 0 7 7 0 1 1 1 0 0 0
0 0 1 1 1 1 4 0 7 7 7 7 0 4 1 1 1 1 0 0
0 2 1 1 1 1 4 1 0 7 7 0 1 4 1 1 1 1 2 0
2 2 0 6 0 1 4 0 1 0 0 1 0 4 1 0 6 0 2 2
2 2 6 0 6 1 4 1 0 0 0 0 1 4 1 6 0 6 2 2
2 2 0 6 0 1 4 1 1 0 0 5 0 4 1 0 6 0 2 2
2 2 6 0 6 1 4 0 2 0 5 1 5 4 1 6 0 6 2 2
2 2 0 6 0 1 4 2 1 2 0 5 0 4 1 0 6 0 2 2
2 2 1 1 1 1 4 0 2 0 5 1 5 4 1 1 1 1 2 2
2 2 1 1 1 1 4 2 1 2 0 5 0 4 1 1 1 1 2 2
0 2 1 1 0 1 4 0 2 0 5 1 5 4 1 0 1 1 2 0
6 0 5 0 5 0 4 2 1 2 0 5 0 4 0 5 0 5 0 6
6 6 0 5 0 5 4 0 2 0 5 1 5 4 5 0 5 0 6 6
6 6 7 0 5 0 4 2 1 2 0 5 0 4 0 5 0 7 6 6
6 0 7 7 0 5 4 0 2 0 5 1 5 4 5 0 7 7 0 6
0 0 0 7 7 0 4 2 1 2 0 5 0 4 0 7 7 0 0 0
0 0 7 7 7 7 4 0 2 0 0 0 0 4 7 7 7 7 0 0
7
0 7 7 0 6 6 6 6 6 6 6 6 6 6 6 6 0 7 7 0
1 0 7 0 0 1 0 1 1 0 0 1 1 0 1 0 0 7 0 1
1 1 0 7 7 0 1 1 1 0 0 1 1 1 0 7 7 0 1 1
0 1 1 0 7 0 0 1 1 2 5 1 1 0 0 7 0 1 1 0
0 1 1 1 0 7 7 0 1 5 2 1 0 7 7 0 1 1 1 0
0 1 1 1 1 0 7 0 0 2 5 0 0 7 0 1 1 1 1 0
4 0 4 0 4 0 0 7 7 5 2 7 7 0 0 4 0 4 0 4
0 4 0 4 0 4 0 0 7 2 5 7 0 0 4 0 4 0 4 0
5 5 5 5 5 5 5 5 0 5 2 0 5 5 5 5 5 5 5 5
0 0 0 0 0 0 0 0 0 2 5 0 0 0 0 0 0 0 0 0
0 0 0 0 0 0 0 0 0 5 2 0 0 0 0 0 0 0 0 0
0 6 0 6 0 6 0 6 0 2 5 0 6 0 6 0 6 0 6 0
6 0 6 0 6 0 6 0 3 5 2 3 0 6 0 6 0 6 0 6
0 6 0 6 0 6 0 3 3 2 5 3 3 0 6 0 6 0 6 0
6 0 6 0 6 0 3 3 3 5 2 3 3 3 0 6 0 6 0 6
0 6 0 6 0 7 3 3 0 2 5 0 3 3 7 0 6 0 6 0
6 0 6 0 0 7 7 0 0 5 2 0 0 7 7 0 0 6 0 6
0 6 0 1 1 0 7 7 0 2 5 0 7 7 0 1 1 0 6 0
6 0 1 1 1 1 0 7 7 5 2 7 7 0 1 1 1 1 0 6
0 1 1 1 1 1 1 0 7 2 5 7 0 1 1 1 1 1 1 0
8
0 1 1 1 1 1 1 1 1 6 0 1 1 1 1 1 1 1 1 0
0 0 5 5 5 0 7 0 7 0 6 7 0 7 0 5 5 5 0 0
4 0 0 5 5 5 0 7 7 6 0 7 7 0 5 5 5 0 0 4
0 4 6 0 5 0 7 0 7 0 6 7 0 7 0 5 0 6 4 0
4 0 1 0 0 7 1 5 1 6 0 1 5 1 7 0 0 1 0 4
0 4 6 2 7 0 5 0 5 0 6 5 0 5 0 7 2 6 4 0
4 0 1 0 7 1 1 5 1 6 0 1 5 1 1 7 0 1 0 4
0 4 6 2 1 7 1 1 1 0 6 1 1 1 7 1 2 6 4 0
4 0 1 0 1 1 0 3 0 0 0 0 3 0 1 1 0 1 0 4
0 4 6 2 1 1 3 0 5 0 0 5 0 3 1 1 2 6 4 0
4 0 1 0 1 1 3 0 5 0 0 5 0 3 1 1 0 1 0 4
0 4 6 2 1 1 0 3 0 0 0 0 3 0 1 1 2 6 4 0
4 0 1 0 2 1 2 1 2 6 0 2 1 2 1 2 0 1 0 4
0 4 6 2 1 2 1 2 1 0 6 1 2 1 2 1 2 6 4 0
4 0 1 0 1 0 7 0 1 6 0 1 0 7 0 1 0 1 0 4
0 4 6 2 1 7 0 7 1 0 6 1 7 0 7 1 2 6 4 0
4 0 1 0 1 0 0 0 1 6 0 1 0 0 0 1 0 1 0 4
0 4 6 2 1 7 0 7 1 0 6 1 7 0 7 1 2 6 4 0
4 0 1 0 1 0 7 0 1 6 0 1 0 7 0 1 0 1 0 4
0 4 6 2 1 1 1 1 1 0 6 1 1 1 1 1 2 6 4 0
9
0 1 2 2 2 6 2 2 2 6 6 3 3 3 7 3 3 3 1 0
5 0 1 2 6 0 6 0 2 0 0 3 0 7 0 7 3 1 0 5
0 5 0 1 2 6 0 2 2 5 5 3 3 0 7 3 1 0 5 0
6 0 5 0 1 0 2 0 2 0 0 3 0 3 0 1 0 5 0 6
0 6 0 5 0 1 2 2 2 6 6 3 3 3 1 0 5 0 6 0
7 0 6 0 5 0 1 2 2 0 0 3 3 1 0 5 0 6 0 7
0 7 0 6 0 5 0 1 2 7 7 3 1 0 5 0 6 0 7 0
2 0 7 0 6 0 5 0 1 0 0 1 0 5 0 6 0 7 0 2
0 2 0 7 0 6 0 5 0 2 2 0 5 0 6 0 7 0 2 0
4 0 2 0 7 0 6 0 5 0 0 5 0 6 0 7 0 2 0 4
0 4 0 2 0 7 0 6 0 5 5 0 6 0 7 0 2 0 4 0
7 0 4 0 2 0 7 0 6 0 0 6 0 7 0 2 0 4 0 7
7 1 0 4 0 2 0 7 0 6 6 0 7 0 2 0 4 0 1 7
7 1 7 0 4 0 2 0 7 0 0 7 0 2 0 4 0 7 1 7
7 1 6 1 0 4 0 2 0 7 7 0 2 0 4 0 1 6 1 7
7 6 0 6 7 0 4 0 2 0 0 2 0 4 0 7 6 0 6 7
7 0 0 0 7 1 0 4 0 2 2 0 4 0 1 7 0 0 0 7
7 6 0 6 7 1 7 0 4 0 0 4 0 7 1 7 6 0 6 7
7 1 6 1 7 1 7 1 0 4 4 0 1 7 1 7 1 6 1 7
7 1 7 1 7 1 7 1 7 0 0 7 1 7 1 7 1 7 1 7
10
2 2 1 5 1 1 1 3 1 0 5 1 3 1 1 1 5 1 2 2
0 2 1 5 7 0 7 3 1 5 0 1 3 7 0 7 5 1 2 0
6 0 1 5 0 7 0 3 1 0 5 1 3 0 7 0 5 1 0 6
6 6 0 5 7 0 7 3 1 5 0 1 3 7 0 7 5 0 6 6
2 6 6 0 1 1 1 3 1 0 5 1 3 1 1 1 0 6 6 2
2 2 6 6 0 1 1 3 1 5 0 1 3 1 1 0 6 6 2 2
1 2 2 6 6 0 1 3 1 0 0 1 3 1 0 6 6 2 2 1
1 1 2 2 6 6 0 3 0 6 6 0 3 0 6 6 2 2 1 1
1 1 1 2 2 6 6 0 0 6 6 0 0 6 6 2 2 1 1 1
7 0 7 0 7 0 7 0 2 0 7 2 0 7 0 7 0 7 0 7
0 7 0 7 0 7 0 0 2 7 0 2 0 0 7 0 7 0 7 0
1 1 1 2 2 4 4 0 0 6 6 0 0 4 4 2 2 1 1 1
1 1 2 2 4 4 0 7 0 6 6 0 7 0 4 4 2 2 1 1
1 2 2 4 4 0 1 7 4 0 0 4 7 1 0 4 4 2 2 1
2 2 4 4 0 1 1 7 4 0 5 4 7 1 1 0 4 4 2 2
2 3 4 0 1 6 1 7 4 5 0 4 7 1 6 1 0 4 4 2
3 4 0 1 6 0 6 7 4 0 5 4 7 6 0 6 1 0 4 4
4 0 1 1 0 0 0 7 4 5 0 4 7 0 0 0 1 1 0 4
0 7 1 1 6 0 6 7 4 0 5 4 7 6 0 6 1 1 7 0
7 7 1 1 1 6 1 7 4 5 0 4 7 1 6 1 1 1 7 7
